165 149 133 118 102 86 71 55 40 24 9 24 40 55 71 86 102 118 133 149
149 133 118 102 86 71 55 40 24 9 24 40 55 71 86 102 118 133 149 165
133 118 102 86 71 55 40 24 9 24 40 55 71 86 102 118 133 149 165 178
118 102 86 71 55 40 24 9 24 40 55 71 86 102 118 133 149 165 178 190
102 86 71 55 40 24 9 24 40 55 71 86 102 118 133 149 165 178 190 201
86 71 55 40 24 9 24 40 55 71 86 102 118 133 149 165 178 190 201 211
71 55 40 24 9 24 40 55 71 86 102 118 133 149 165 178 190 201 211 220
55 40 24 9 24 40 55 71 86 102 118 133 149 165 178 190 201 211 220 228
40 24 9 24 40 55 71 86 102 118 133 149 165 178 190 201 211 220 228 235
24 9 24 40 55 71 86 102 118 133 149 165 178 190 201 211 220 228 235 241