10 12 14 16 18 20 22 24 26 28 30 32 34 36 38 40 42 44
12 14 16 18 20 22 24 26 28 30 32 34 36 38 40 42 44 46
14 16 18 20 22 24 26 28 30 32 34 36 38 40 42 44 46 48
16 18 20 22 24 26 28 30 32 34 36 38 40 42 44 46 48 50
18 20 22 24 26 28 30 32 34 36 38 40 42 44 46 48 50 52
20 22 24 26 28 30 32 34 36 38 40 42 44 46 48 50 52 54
22 24 26 28 30 32 34 36 38 40 42 44 46 48 50 52 54 56
24 26 28 30 32 34 36 38 150 152 40 42 44 46 48 50 52 54
26 28 30 32 34 36 38 150 152 154 156 42 44 46 48 50 52 54
28 30 32 34 36 38 150 152 154 156 158 160 44 46 48 50 52 54
30 32 34 36 38 150 152 154 156 158 160 162 164 48 50 52 54 56
32 34 36 38 150 152 154 156 158 160 162 164 166 168 52 54 56 58
34 36 38 150 152 154 156 158 160 162 164 166 168 170 172 56 58 60
36 38 150 152 154 156 158 160 162 164 166 168 170 172 174 176 60 62
38 150 152 154 156 158 160 162 164 166 168 170 172 174 176 178 180 64
40 152 154 156 158 160 162 164 166 168 170 172 174 176 178 180 182 184
42 154 156 158 160 162 164 166 168 170 172 174 176 178 180 182 184 186
44 156 158 160 162 164 166 168 170 172 174 176 178 180 182 184 186 188