0 10 21 31 42 53 63 74 84 95 106 116 127 137 148 159 169 180 190 201
10 21 31 42 53 63 74 84 95 106 116 127 137 148 159 169 180 190 201 211
21 31 42 53 63 74 84 95 106 116 127 137 148 159 169 180 190 201 211 220
31 42 53 63 74 84 95 106 116 127 137 148 159 169 180 190 201 211 220 228
42 53 63 74 84 95 106 116 127 137 148 159 169 180 190 201 211 220 228 235
53 63 74 84 95 106 116 127 137 148 159 169 180 190 201 211 220 228 235 241
63 74 84 95 106 116 127 137 148 159 169 180 190 201 211 220 228 235 241 247
74 84 95 106 116 127 137 148 159 169 180 190 201 211 220 228 235 241 247 252
84 95 106 116 127 137 148 159 169 180 190 201 211 220 228 235 241 247 252 255
95 106 116 127 137 148 159 169 180 190 201 211 220 228 235 241 247 252 255 255