20 20 20 22 22 22 24 24 24 180 180 182 182 184 184 186 186 188
20 20 20 22 22 22 24 24 24 180 180 182 182 184 184 186 186 188
20 20 20 22 22 22 24 24 24 180 180 182 182 184 184 186 186 188
22 22 22 24 24 24 26 26 26 182 182 184 184 186 186 188 188 190
22 22 22 24 24 24 26 26 26 182 182 184 184 186 186 188 188 190
22 22 22 24 24 24 26 26 26 182 182 184 184 186 186 188 188 190
24 24 24 26 26 26 28 28 28 184 184 186 186 188 188 190 190 192
24 24 24 26 26 26 28 28 28 184 184 186 186 188 188 190 190 192
24 24 24 26 26 26 28 28 28 184 184 186 186 188 188 190 190 192
180 180 180 182 182 182 184 184 184 30 30 32 32 34 34 36 36 38
180 180 180 182 182 182 184 184 184 30 30 32 32 34 34 36 36 38
180 180 180 182 182 182 184 184 184 30 30 32 32 34 34 36 36 38
182 182 182 184 184 184 186 186 186 32 32 34 34 36 36 38 38 40
182 182 182 184 184 184 186 186 186 32 32 34 34 36 36 38 38 40
182 182 182 184 184 184 186 186 186 32 32 34 34 36 36 38 38 40
184 184 184 186 186 186 188 188 188 34 34 36 36 38 38 40 40 42
184 184 184 186 186 186 188 188 188 34 34 36 36 38 38 40 40 42
184 184 184 186 186 186 188 188 188 34 34 36 36 38 38 40 40 42