10 20 30 40 50 60 70 80 90
10 20 30 40 50 60 70 80 90
12 22 32 42 52 62 72 82 92
12 22 32 42 52 62 72 82 92
14 24 34 44 54 64 74 84 94
14 24 34 44 54 64 74 84 94
16 26 36 46 56 66 76 86 96
16 26 36 46 56 66 76 86 96
18 28 38 48 58 68 78 88 98