5 5 5 5 5 5 5 5 5
10 10 10 10 10 10 10 10 10
20 20 20 20 20 20 20 20 20
40 40 40 40 40 40 40 40 40
80 80 80 80 80 80 80 80 80
120 120 120 120 120 120 120 120 120
180 180 180 180 180 180 180 180 180
220 220 220 220 220 220 220 220 220
243 243 243 243 243 243 243 243 243