10 10 10 20 20 20 30 30 30
10 10 20 20 20 30 30 30 40
10 20 20 20 30 30 30 40 40
20 20 20 30 30 30 40 40 50
20 20 30 30 30 40 40 50 50
20 30 30 30 40 40 50 50 60
30 30 30 40 40 50 50 60 60
30 30 40 40 50 50 60 60 70
30 40 40 50 50 60 60 70 70