20 20 20 20 20 20 20 20 20
20 30 30 30 30 30 30 30 20
20 30 100 100 100 100 100 30 20
20 30 100 150 150 150 100 30 20
20 30 100 150 200 150 100 30 20
20 30 100 150 150 150 100 30 20
20 30 100 100 100 100 100 30 20
20 30 30 30 30 30 30 30 20
20 20 20 20 20 20 20 20 20